####################
#..................#
###############....#
#.............#....#
#....#........#....#
#....#........#....#
#....#........#....#
#....#........#....#
#....##########....#
#....#........#....#
#....#........#....#
#....#........#....#
#....#...#....#....#
#....#...#....#....#
#....#...#....#....#
#....#...#.........#
#....#...#....######
#....#####....#....#
#..................#
####################