#####################
#.........#...#..#..#
#.#.#...#...#...#...#
#.#..#.#..#..#.#.#..#
#..#..#.......#..#.##
#.#..#....#..#.#.#..#
#.#.#.......#....#..#
#..#..###.#.#..#...##
#...##..#......##...#
#.........#..#..#...#
#.#.#.#.#...#.#.#.#.#
#...#.##..#.........#
#...#..........##...#
#..#...#..#......#..#
#..#..##........#...#
#..###....#....#....#
#.....##......#.....#
#....#.#..#..#.#....#
#...#...#...#...#...#
#.........#.........#
#####################