####################
#...#.........#....#
#...#.........#....#
#...#.........#....#
#...#.........#....#
#...#.........#....#
#...#....#....#....#
#...#....#....#....#
#........#....#....#
#........#....#....#
#........#.........#
#####....#.........#
#........#.........#
#........#.........#
#....#...#......####
#....#...#.........#
#....#...#.....#...#
#....#...#.....#...#
#....#...#.....#...#
####################